school_year,lea_name,lea_code,school_name,school_code,elem_sec_classification,poverty_quartile,num_total_classes,num_hq_classes,num_nhq_classes
2013-2014,Basis DC PCS,168,Basis DC PCS,3068,SEC,1,173,166,7
2013-2014,Capital City PCS,108,Capital City High School PCS,1207,SEC,1,209,209,0
2013-2014,District of Columbia Public Schools,001,Cardozo EC,454,SEC,1,158,111,47
2013-2014,District of Columbia Public Schools,001,CHOICE Academy at Emery,947,SEC,1,20,20,0
2013-2014,District of Columbia Public Schools,001,Coolidge HS,455,SEC,1,139,115,24
2013-2014,District of Columbia Public Schools,001,Deal MS,405,ELEM,1,81,31,50
2013-2014,District of Columbia Public Schools,001,Deal MS,405,SEC,1,240,185,55
2013-2014,E.L. Haynes PCS,116,E.L. Haynes Kansas Avenue - High School,1138,SEC,1,93,88,5
2013-2014,District of Columbia Public Schools,001,Ellington School of the Arts,471,SEC,1,27,27,0
2013-2014,District of Columbia Public Schools,001,Hardy MS,246,ELEM,1,25,15,10
2013-2014,District of Columbia Public Schools,001,Hardy MS,246,SEC,1,86,70,16
2013-2014,District of Columbia Public Schools,001,McKinley Technology HS,458,SEC,1,269,200,69
2013-2014,District of Columbia Public Schools,001,Roosevelt HS at MacFarland,459,SEC,1,136,111,25
2013-2014,District of Columbia Public Schools,001,School Without Walls HS,466,SEC,1,207,188,19
2013-2014,District of Columbia Public Schools,001,Stuart Hobson MS (Capitol Hill Cluster),428,ELEM,1,20,15,5
2013-2014,District of Columbia Public Schools,001,Stuart Hobson MS (Capitol Hill Cluster),428,SEC,1,64,54,10
2013-2014,Washington Latin PCS,151,Washington Latin PCS - Middle School,125,SEC,1,44,43,1
2013-2014,Washington Latin PCS,151,Washington Latin PCS - Upper School,1118,SEC,1,64,64,0
2013-2014,District of Columbia Public Schools,001,Wilson HS,463,SEC,1,455,407,48
2013-2014,District of Columbia Public Schools,001,Anacostia HS,450,SEC,2,153,122,31
2013-2014,District of Columbia Public Schools,001,Ballou HS,452,SEC,2,174,168,6
2013-2014,District of Columbia Public Schools,001,Benjamin Banneker HS,402,SEC,2,125,125,0
2013-2014,Capital City PCS,108,Capital City Middle School,182,SEC,2,152,152,0
2013-2014,District of Columbia Public Schools,001,Dunbar HS,467,SEC,2,131,113,18
2013-2014,E.L. Haynes PCS,116,E L  Haynes PCS Georgia Avenue,146,SEC,2,119,103,16
2013-2014,District of Columbia Public Schools,001,Eastern HS,457,SEC,2,202,153,49
2013-2014,District of Columbia Public Schools,001,Eliot Hine MS,407,ELEM,2,8,8,0
2013-2014,District of Columbia Public Schools,001,Eliot Hine MS,407,SEC,2,77,58,19
2013-2014,Friendship PCS,120,Friendship PCS Woodridge Middle,366,SEC,2,23,23,0
2013-2014,Howard University Middle School of Math and Science,124,Howard University Middle School of Math and Science PCS,115,SEC,2,23,21,2
2013-2014,District of Columbia Public Schools,001,Luke Moore Alternative HS,884,SEC,2,84,52,32
2013-2014,Paul PCS,138,Paul PCS-International High School,222,SEC,2,17,17,0
2013-2014,Thurgood Marshall Academy,146,Thurgood Marshall Academy,191,SEC,2,135,135,0
2013-2014,District of Columbia Public Schools,001,Washington Metropolitan HS (formerly YEA),474,SEC,2,40,31,9
2013-2014,District of Columbia Public Schools,001,Woodson H D HS,464,SEC,2,237,210,27
2013-2014,Cesar Chavez PCS,109,Cesar Chavez for Public Policy-Capitol Hill PCS,153,SEC,3,144,144,0
2013-2014,Cesar Chavez PCS,109,Cesar Chavez PCS for Public Policy-Parkside HS,109,SEC,3,133,133,0
2013-2014,D.C. Preparatory Academy PCS,115,D C  Prep-Edgewood Middle Campus PCS,196,SEC,3,47,47,0
2013-2014,District of Columbia Public Schools,001,Hart MS,413,ELEM ,3,13,7,6
2013-2014,District of Columbia Public Schools,001,Hart MS,413,SEC,3,31,24,7
2013-2014,IDEA PCS,126,IDEA PCS,163,SEC,3,77,77,0
2013-2014,District of Columbia Public Schools,001,Jefferson Middle School Academy,433,ELEM,3,16,12,4
2013-2014,District of Columbia Public Schools,001,Jefferson Middle School Academy,433,SEC,3,42,22,20
2013-2014,District of Columbia Public Schools,001,Johnson  John Hayden MS,416,ELEM,3,16,4,12
2013-2014,District of Columbia Public Schools,001,Johnson  John Hayden MS,416,SEC,3,58,23,35
2013-2014,District of Columbia Public Schools,001,Kelly Miller MS,421,ELEM,3,24,20,4
2013-2014,District of Columbia Public Schools,001,Kelly Miller MS,421,SEC,3,68,51,17
2013-2014,KIPP DC PCS,129,KIPP DC College Prep PCS,1123,SEC,3,122,122,0
2013-2014,KIPP DC PCS,129,KIPP DC KEY Academy PCS,189,SEC,3,72,72,0
2013-2014,KIPP DC PCS,129,KIPP DC WILL Academy PCS,121,SEC,3,89,89,0
2013-2014,District of Columbia Public Schools,001,Kramer MS,417,ELEM,3,18,15,3
2013-2014,District of Columbia Public Schools,001,Kramer MS,417,SEC,3,18,9,9
2013-2014,Paul PCS,138,Paul PCS-Middle School,170,SEC,3,29,29,0
2013-2014,District of Columbia Public Schools,001,Phelps Architecture Construction and Engineering HS,478,SEC,3,112,83,29
2013-2014,SEED PCS of Washington DC,142,SEED PCS of Washington DC,174,SEC,3,110,110,0
2013-2014,Somerset PCS,175,Somerset Preparatory Academy PCS,187,SEC,3,6,3,3
2013-2014,District of Columbia Public Schools,001,Sousa MS,427,ELEM,3,16,16,0
2013-2014,District of Columbia Public Schools,001,Sousa MS,427,SEC,3,42,38,4
2013-2014,Achievement Preparatory Academy PCS,155,Achievement Preparatory Academy PCS-Middle School,1100,SEC,4,122,122,0
2013-2014,Booker T. Washington PCS,106,Booker T  Washington PCS,151,"SEC, ADULT",4,66,66,0
2013-2014,Cesar Chavez PCS,109,Cesar Chavez for Public Policy-Parkside MS PCS,102,SEC,4,69,69,0
2013-2014,Cesar Chavez PCS,109,Cesar Chavez PCS for Public Policy-Chavez Prep,127,SEC,4,72,72,0
2013-2014,District of Columbia Public Schools,001,Columbia Heights EC (CHEC),442,ELEM,4,11,3,8
2013-2014,District of Columbia Public Schools,001,Columbia Heights EC (CHEC),442,SEC,4,188,163,25
2013-2014,Friendship PCS,120,Friendship PCS Blow Pierce Middle,362,SEC,4,25,20,5
2013-2014,Friendship PCS,120,Friendship PCS Chamberlain Middle,364,SEC,4,45,45,0
2013-2014,Friendship PCS,120,Friendship PCS Technology Preparatory Academy,1124,SEC,4,57,57,0
2013-2014,Friendship PCS,120,Friendship PCS Woodson Collegiate Academy,186,SEC,4,133,131,2
2013-2014,Hospitality PCS,122,Hospitality PCS,160,SEC,4,81,74,7
2013-2014,KIPP DC PCS,129,KIPP DC AIM PCS Academy PCS,116,SEC,4,82,82,0
2013-2014,DYRS,4002,Maya Angelou Academy at New Beginnings,860,SEC,4,42,42,0
2013-2014,Maya Angelou PCS,133,Maya Angelou PCS- Evans Middle School,133,SEC,4,32,28,4
2013-2014,Maya Angelou PCS,133,Maya Angelou PCS-Evans High School,101,SEC,4,128,127,1
2013-2014,National Collegiate Preparatory PCS,163,National Collegiate Prep PCS,1120,SEC,4,37,37,0
2013-2014,Options PCS,137,Options PCS,169,SEC,4,15,15,0
2013-2014,Richard Wright PCS for Journalism and Media Arts,167,Richard Wright PCS for Journalism and Media Arts,3067,SEC,4,22,21,1
2013-2014,Washington Mathematics Science Technology PCHS,152,Washington Math Science Tech PCS,178,SEC,4,155,149,6
2013-2014,District of Columbia Public Schools,001,Youth Services Center,861,SEC,4,42,42,0
2013-2014,Achievement Preparatory Academy PCS,155,Achievement Preparatory Academy PCS-Elementary,217,ELEM,2,12,12,0
2013-2014,Arts and Technology PCS,104,Arts and Technology PCS,181,ELEM,3,28,28,0
2013-2014,District of Columbia Public Schools,001,Ballou STAY,462,SEC,NA,22,15,7
2013-2014,Bridges PCS,107,Bridges PCS,142,ELEM,2,5,5,0
2013-2014,District of Columbia Public Schools,001,Brightwood EC,213,ELEM,2,33,24,9
2013-2014,District of Columbia Public Schools,001,Brightwood EC,213,SEC,2,20,14,6
2013-2014,District of Columbia Public Schools,001,Brookland EC at Bunker Hill,346,ELEM,2,21,11,10
2013-2014,District of Columbia Public Schools,001,Brookland EC at Bunker Hill,346,SEC,2,10,10,0
2013-2014,District of Columbia Public Schools,001,Browne EC,404,ELEM,4,11,9,2
2013-2014,District of Columbia Public Schools,001,Browne EC,404,SEC,4,25,20,5
2013-2014,District of Columbia Public Schools,001,Burroughs EC,220,ELEM,3,9,8,1
2013-2014,District of Columbia Public Schools,001,Burroughs EC,220,SEC,3,10,9,1
2013-2014,District of Columbia Public Schools,001,Burrville ES,221,ELEM,3,1,0,1
2013-2014,Capital City PCS,108,Capital City Lower PCS,184,ELEM,1,16,16,0
2013-2014,Cedar Tree Academy Public Charter School,123,Cedar Tree Academy PCS,188,ELEM,3,3,3,0
2013-2014,Center City PCS,156,Center City Brightwood Campus PCS,1103,ELEM,2,37,37,0
2013-2014,Center City PCS,156,Center City Capitol Hill Campus PCS,1104,ELEM,2,46,46,0
2013-2014,Center City PCS,156,Center City Congress Heights Campus PCS,1105,ELEM,4,38,33,5
2013-2014,Center City PCS,156,Center City Petworth Campus PCS,1106,ELEM,1,47,46,1
2013-2014,Center City PCS,156,Center City Shaw Campus PCS,1107,ELEM,3,45,44,1
2013-2014,Center City PCS,156,Center City Trinidad Campus PCS,1108,ELEM,3,45,44,1
2013-2014,Community Academy PCS,113,Community Academy Amos I,105,ELEM,2,23,23,0
2013-2014,Community Academy PCS,113,Community Academy Amos II,158,ELEM,3,5,5,0
2013-2014,Community Academy PCS,113,Community Academy Amos III,1109,ELEM,4,17,17,0
2013-2014,Community Academy PCS,113,Community Academy Butler Global,106,ELEM,2,23,22,1
2013-2014,Community Academy PCS,113,Community Academy CAPCS Online,108,ELEM,1,15,15,0
2013-2014,Creative Minds International PCS,169,Creative Minds International PCS,3069,ELEM,1,19,15,4
2013-2014,D.C. Preparatory Academy PCS,115,D C  Prep-Benning Elementary PCS,1110,ELEM,2,29,29,0
2013-2014,D.C. Preparatory Academy PCS,115,D C  Prep-Edgewood Elementary PCS,130,ELEM,2,29,29,0
2013-2014,D.C. Preparatory Academy PCS,115,D C Preparatory Benning Middle Campus,218,ELEM,3,10,10,0
2013-2014,DC Bilingual PCS,114,DC Bilingual PCS,199,ELEM,2,22,19,3
2013-2014,DC Scholars Public Charter School,170,DC Scholars PCS,3070,ELEM,4,16,15,1
2013-2014,E.L. Haynes PCS,116,E.L. Haynes PCS Kansas Avenue (Elementary School),1206,ELEM,1,97,97,0
2013-2014,Eagle Academy PCS,117,Eagle Academy PCS - Eagle Center at McGogney,195,ELEM,3,31,22,9
2013-2014,Eagle Academy PCS,117,Eagle Academy PCS New Jersey Avenue Campus,1125,ELEM,2,6,2,4
2013-2014,Early Childhood Academy PCS,118,Early Childhood Academy PCS Johenning Campus,138,ELEM,3,9,7,2
2013-2014,Elsie Whitlow Stokes Community Freedom PCS,144,Elsie Whitlow Stokes Community Freedom PCS,159,ELEM,1,36,36,0
2013-2014,Excel Academy PCS,158,Excel Academy PCS,1113,ELEM,3,40,31,9
2013-2014,Friendship PCS,120,Friendship PCS Blow Pierce Elementary,361,ELEM,4,25,21,4
2013-2014,Friendship PCS,120,Friendship PCS Chamberlain Elementary,363,ELEM,3,48,47,1
2013-2014,Friendship PCS,120,Friendship PCS SouthEast Academy,113,ELEM,4,25,23,2
2013-2014,Friendship PCS,120,Friendship PCS Woodridge Elementary,365,ELEM,2,29,28,1
2013-2014,Hope Community Academy PCS,121,Hope Community PCS Lamond Campus,131,ELEM,2,15,13,2
2013-2014,Hope Community Academy PCS,121,Hope Community PCS Tolson Campus,114,ELEM,2,20,16,4
2013-2014,District of Columbia Public Schools,001,Houston ES,251,ELEM,4,4,4,0
2013-2014,Ideal Academy PCS,127,Ideal Academy PCS North Capitol Street Campus ES,134,ELEM,3,45,27,18
2013-2014,Imagine Southeast PCS,159,Imagine Southeast PCS,1116,ELEM,4,45,41,4
2013-2014,District of Columbia Public Schools,001,"Incarcerated Youth Program, Correctional Detention Facility",480,SEC,NA,15,15,0
2013-2014,Ingenuity Prep PCS,173,Ingenuity Prep PCS,200,ELEM,4,6,6,0
2013-2014,Inspired Teaching Demonstration PCS,165,Inspired Teaching Demonstration PCS,3064,ELEM,1,19,19,0
2013-2014,KIPP DC PCS,129,KIPP DC Discover Academy PCS,1122,ELEM,3,4,4,0
2013-2014,KIPP DC PCS,129,KIPP DC Grow Academy PCS,1129,ELEM,2,4,4,0
2013-2014,KIPP DC PCS,129,KIPP DC Heights Academy PCS,3071,ELEM,3,14,14,0
2013-2014,KIPP DC PCS,129,KIPP DC Lead Academy PCS,190,ELEM,2,11,11,0
2013-2014,KIPP DC PCS,129,KIPP DC LEAP Academy PCS,132,ELEM,3,4,4,0
2013-2014,KIPP DC PCS,129,KIPP DC Promise Academy PCS,1121,ELEM,3,24,24,0
2013-2014,KIPP DC PCS,129,KIPP DC Spring Academy PCS,214,ELEM,3,3,3,0
2013-2014,District of Columbia Public Schools,001,Langdon EC,262,ELEM,3,18,17,1
2013-2014,District of Columbia Public Schools,001,Langdon EC,262,SEC,3,24,16,8
2013-2014,District of Columbia Public Schools,001,LaSalle Backus EC,264,ELEM,3,20,19,1
2013-2014,District of Columbia Public Schools,001,LaSalle Backus EC,264,SEC,3,21,12,9
2013-2014,Latin American Montessori Bilingual (LAMB) PCS,130,Latin American Montessori Bilingual (LAMB) PCS,193,ELEM,1,23,22,1
2013-2014,Mary McLeod Bethune PCS,132,Mary McLeod Bethune PCS Slowe Campus,135,ELEM,3,62,61,1
2013-2014,Meridian PCS,135,Meridian PCS,165,ELEM,2,39,24,15
2013-2014,Mundo Verde Bilingual PCS,171,Mundo Verde Bilingual PCS,3065,ELEM,1,19,18,1
2013-2014,District of Columbia Public Schools,001,Noyes EC,290,ELEM,3,13,9,4
2013-2014,District of Columbia Public Schools,001,Noyes EC,290,SEC,3,18,14,4
2013-2014,District of Columbia Public Schools,001,Oyster Adams Bilingual School (Oyster),292,ELEM,1,16,16,0
2013-2014,District of Columbia Public Schools,001,Oyster Adams Bilingual School (Oyster),292,SEC,1,40,36,4
2013-2014,Perry Street Prep PCS,125,Perry Street Prep PCS,161,ELEM,2,117,111,6
2013-2014,District of Columbia Public Schools,001,Plummer ES,299,ELEM,4,2,2,0
2013-2014,Potomac Lighthouse PCS,139,Potomac Lighthouse PCS,117,ELEM,3,28,3,25
2013-2014,District of Columbia Public Schools,001,Raymond EC,302,ELEM,2,24,24,0
2013-2014,District of Columbia Public Schools,001,Raymond EC,302,SEC,2,21,13,8
2013-2014,District of Columbia Public Schools,001,Roosevelt STAY at MacFarland,456,SEC,NA,14,13,1
2013-2014,District of Columbia Public Schools,001,School Without Walls at Francis Stevens,409,ELEM,1,8,7,1
2013-2014,Sela PCS,174,Sela PCS,197,ELEM,1,3,0,3
2013-2014,Shining Stars Montessori PCS,166,Shining Stars Montessori PCS,3066,ELEM,1,1,1,0
2013-2014,District of Columbia Public Schools,001,Stanton ES,319,ELEM,4,4,4,0
2013-2014,District of Columbia Public Schools,001,Takoma EC,324,ELEM,2,31,29,2
2013-2014,District of Columbia Public Schools,001,Takoma EC,324,SEC,2,37,24,13
2013-2014,Tree of Life PCS,147,Tree of Life PCS,183,ELEM,3,11,8,3
2013-2014,District of Columbia Public Schools,001,Truesdell EC,327,ELEM,3,20,18,2
2013-2014,District of Columbia Public Schools,001,Truesdell EC,327,SEC,3,27,18,9
2013-2014,Two Rivers PCS,149,Two Rivers PCS,198,ELEM,1,110,109,1
2013-2014,District of Columbia Public Schools,001,Walker Jones EC,332,ELEM,4,19,11,8
2013-2014,District of Columbia Public Schools,001,Walker Jones EC,332,SEC,4,22,18,4
2013-2014,Washington Yu Ying PCS,160,Washington Yu Ying PCS,1117,ELEM,1,47,46,1
2013-2014,District of Columbia Public Schools,001,West EC,336,ELEM,2,10,8,2
2013-2014,District of Columbia Public Schools,001,West EC,336,SEC,2,18,15,3
2013-2014,District of Columbia Public Schools,001,Wheatley EC,335,ELEM,4,14,14,0
2013-2014,District of Columbia Public Schools,001,Wheatley EC,335,SEC,4,20,18,2
2013-2014,District of Columbia Public Schools,001,Whittier EC,338,ELEM,3,22,21,1
2013-2014,District of Columbia Public Schools,001,Whittier EC,338,SEC,3,15,6,9
2013-2014,William E. Doar Jr. PCS,153,William E. Doar Jr. PCS,210,ELEM,2,39,39,0
,,,,,,,,,
